7
.##...##.
#..#.#..#
#...#...#
.#.....#.
..#...#..
...#.#...
....#....